NO ./textures/backroom_wall_texture_03.xpm
SO ./textures/backroom_wall_texture_03.xpm
WE ./textures/backroom_wall_texture_03.xpm
EA ./textures/backroom_wall_texture_03.xpm
EA ./textures/backroom_wall_texture_03.xpm


C 180,175,160

        1111111111111111111111111
        1000000000110000000000001
1       1011000001110000000000001
1       1001000000000000000000001
111111111011000001110000000000001
100000000011000001110111111111111
11110111111111011100000010001
11110111111111011101010010001
110000001101010111000000O0001
10000000000000001100000010001
10000000000000001101010010001
11000001110101011111011110W0111
11110111 1110101 101111010001
11111111 1111111 111111111111
